11111111111111111
10000000000000001
10000000000000001
10000000C00000001
100000000C0000001
10P000CCCCC000E01
100000000C0000001
10000000C00000001
10000000000000001
10000000000000001
11111111111111111