1111111111111111111111111111111111
1E000000000000000C0000000000000111
1010100010000000001010000100010101
1000000001010000100010100111010001
101010P010000C00000000000000000101
1111111111111111111111111111111111