1111111111111111111111111111111111111111111111111
1E10000000000000000000000000000000000000000000C01
1000100000000000001000000000000000000000000000001
1000000010000000100000000010000000100000000000001
1000000000000000000000000000000000000000000100001
10000000000000000000000000V0000000000000000000001
10000000000000000000000000V0000000000000000000001
10000000000000000000000000V0000000000000000000001
1010100000000P000000000000V0000000100001000000001
10000000000000000000000000V0000000000000000000011
1000000000000000000000000000000000000000000000001
101000C000C00000000000000000000000000000000000001
1000000000000000000000000000000000000000000000001
1111111111111111111111111111111111111111111111111