11111111111111111
10000000000000001
10000000000000001
10000000C00010001
100000000C0010001
10P000CCCCC010E01
100000000C0010001
10000000C00010001
10000000000000001
10000000000000001
11111111111111111