11111111111111111111111111111111111111111111111111
1P0C0000000000000000000000000000000000000000000001
10111101110111101110111101110111101110111101110101
10100001000100001000100001000100001000100001000101
10101101010110101010101101010101101010101101010101
10001000001000100001000100001000100001000100001001
10111011110111101110111101110111101110111101110101
10001000001000100001000100001000100001000100001001
10101101010110101010101101010101101010101101010101
10100001000100001000100001000100001000100001000101
10110111011101110111011101110111011101110111011101
10001000001000100001000100001000100001000100001001
10100101001010100101001010100101001010100101010101
10100001000100001100010000100010000100010000100E01
11111111111111111111111111111111111111111111111111