111111111111111
100000000000001
101111011101101
101000010001001
101011010101101
100010000010001
101110111101101
100010000010001
101011010101101
101000010001001
101101110111101
1000P0000010001
101001010010101
1010000E00010C1
111111111111111