111111111111111
1P1110111011101
10100100011E101
101111111110101
10100C000010101
101011111010101
101000001010101
101011111010101
101000001010101
101011111110101
100000000000101
101111111111101
10000000C000001
101111111111101
10000000000C001
111111111111111