1111111111111111111111111111111111
100000000100000C00000000000E000001
1000001000100101000000000000000101
1000000000000000000010001001000011
101010P00C00C000001000000010000101
1111111111111111111111111111111111