1111111111111111111111111111111111
1E0000000C000000000000000000000001
1010100000000000000000000000000101
1000000000000000000000000000100011
101010P010000000000C00000000000011
1111111111111111111111111111111111